                                                           *
                       **          **** ********           *

            **                  *
                                *
*                               *
                                *
                   ****     *** *
                                *
*                               *
                                *
                            ***       *
                                              *
                                                  *
      ***                                            *
                                *     *** *
   *******         ****              ***
                                   *****
                         *                             *
                            **                 ***
                                         *
                                         *                 *
************************************************************